Stage 1
#####
#OoP#
#####
=====
Stage 2
######
#  P #
#o####
# #
#O#
###
=====
Stage 3
######
#P   #
# Oo #
######
=====
Stage 4
######
#P   #
# #oO#
#    #
#    #
######
=====
Stage 5
######
#P   #
#  oO#
#    #
# Oo #
######
=====